review_instance_id,reviewer_id,gold_frame_assessment,intervention_validity,primary_semantic_phenomenon,diagnostic_failure_locus,recommended_data_action,pass2_confidence,pass2_rationale
R180-0001,,,,,,,,
R180-0002,,,,,,,,
R180-0003,,,,,,,,
R180-0004,,,,,,,,
R180-0005,,,,,,,,
R180-0006,,,,,,,,
R180-0007,,,,,,,,
R180-0008,,,,,,,,
R180-0009,,,,,,,,
R180-0010,,,,,,,,
R180-0011,,,,,,,,
R180-0012,,,,,,,,
R180-0013,,,,,,,,
R180-0014,,,,,,,,
R180-0015,,,,,,,,
R180-0016,,,,,,,,
R180-0017,,,,,,,,
R180-0018,,,,,,,,
R180-0019,,,,,,,,
R180-0020,,,,,,,,
R180-0021,,,,,,,,
R180-0022,,,,,,,,
R180-0023,,,,,,,,
R180-0024,,,,,,,,
R180-0025,,,,,,,,
R180-0026,,,,,,,,
R180-0027,,,,,,,,
R180-0028,,,,,,,,
R180-0029,,,,,,,,
R180-0030,,,,,,,,
R180-0031,,,,,,,,
R180-0032,,,,,,,,
R180-0033,,,,,,,,
R180-0034,,,,,,,,
R180-0035,,,,,,,,
R180-0036,,,,,,,,
R180-0037,,,,,,,,
R180-0038,,,,,,,,
R180-0039,,,,,,,,
R180-0040,,,,,,,,
R180-0041,,,,,,,,
R180-0042,,,,,,,,
R180-0043,,,,,,,,
R180-0044,,,,,,,,
R180-0045,,,,,,,,
R180-0046,,,,,,,,
R180-0047,,,,,,,,
R180-0048,,,,,,,,
R180-0049,,,,,,,,
R180-0050,,,,,,,,
R180-0051,,,,,,,,
R180-0052,,,,,,,,
R180-0053,,,,,,,,
R180-0054,,,,,,,,
R180-0055,,,,,,,,
R180-0056,,,,,,,,
R180-0057,,,,,,,,
R180-0058,,,,,,,,
R180-0059,,,,,,,,
R180-0060,,,,,,,,
R180-0061,,,,,,,,
R180-0062,,,,,,,,
R180-0063,,,,,,,,
R180-0064,,,,,,,,
R180-0065,,,,,,,,
R180-0066,,,,,,,,
R180-0067,,,,,,,,
R180-0068,,,,,,,,
R180-0069,,,,,,,,
R180-0070,,,,,,,,
R180-0071,,,,,,,,
R180-0072,,,,,,,,
R180-0073,,,,,,,,
R180-0074,,,,,,,,
R180-0075,,,,,,,,
R180-0076,,,,,,,,
R180-0077,,,,,,,,
R180-0078,,,,,,,,
R180-0079,,,,,,,,
R180-0080,,,,,,,,
R180-0081,,,,,,,,
R180-0082,,,,,,,,
R180-0083,,,,,,,,
R180-0084,,,,,,,,
R180-0085,,,,,,,,
R180-0086,,,,,,,,
